
R  19200 10800

NO ./textures/walls/25.xpm
SO        ./textures/walls/35.xpm
WE./textures/walls/6.xpm

EA  ./textures/walls/147.xpm
S ./textures/sprites/pillar.xpm
C         254,69,148
F    252,191,0

11111111111111111111111111111111111111111111111111111111
100000000000000000000000000000003000000000000003000000001
100000001000000000000333000000003033300000000003000000001
10000000000111000000334303333333303000000000000330333333311
100000001001010000003000000000000030000000000000000001
10000000000111000003333333333330003000000000000011111
1000000010000000000000000000000300300000000000001
100000000000000E00000000000000000330000000000000011111
10000001000000000000222200000000000000000000000000001
100111100000000000000000000000000000000000000000000001
100000001000111111111000001111111110000000000000000001
100000000001        1000001       10000000000000000001
111111111111        1111111       11111111111111111111



