
R 500 1000 

NO ./textures/walls/25.xpm
SO        ./textures/walls/35.xpm
WE ./textures/walls/6.xpm

EA  ./textures/walls/147.xpm
S ./textures/sprites/pillar.xpm
F    255, 255, 0

C         0,0,0
111111111111111111111111
1111111100000000001111
1000000000001010000001
101111111000111111101
10000000000000000001
1000000000000000001
100000000000000001
10000000000001111
11100000000001
100000000N001
111111111111



