
R02560 00500

NO ./textures/walls/25.xpm
SO        ./textures/walls/35.xpm
WE./textures/walls/6.xpm

EA  ./textures/walls/147.xpm
S ./textures/sprites/pillar.xpm
F    29,191,192
C 225,30,0
        1111111111111111111111111
        1000000000110000000000001
        1011000001110000002000001
        100100000000000000000000111111111
        111111111011000001110000000000001
        100000000011000001111111111111111
11111111111111011100000010001
11110111111111011101010010001
11000000110101011100000010001
10002000000000001100000010001
10000000000000001101010010001
11000001110101011111011110N0111
11110111 1110101 101111010001
11111111 1111111 111111111111
