R       600     500
NO ./textures/walls/25.xpm
SO        ./textures/walls/35.xpm
WE ./textures/walls/6.xpm
EA  ./textures/walls/147.xpm
S ./textures/sprites/pillar.xpm
C         75,69,148
F    29,191,192

11111111111111111111111111111 11111111111111111111111111111
10100000000000000000000100010 00100000000000000000000100011
10110000011100N00000000010001 10000000001100000111011110001
11110111111101011100000010001 11110111111111000001010010001
11000000110101011100000000000 00000100000000001100000010001
10000000000000001101010010001 11000000110101001111011110011
11111111111111111111111111111 11111111111111111111111111111
